13
17
1 1 1 1 1 1 1 1 1 1 1 1 1 1 1 1 1
1 0 4 2 0 0 2 0 2 0 2 0 2 0 2 0 1
1 0 1 0 1 2 1 2 1 5 1 2 1 2 1 0 1
1 0 0 2 0 0 2 0 0 0 2 0 2 0 2 0 1
1 0 1 0 1 2 1 2 1 0 1 2 1 2 1 0 1
1 0 0 2 0 0 3 0 2 0 2 0 2 0 2 0 1
1 2 1 0 1 2 1 2 1 2 1 2 1 2 1 2 1
1 0 0 2 0 0 2 0 2 0 2 0 3 0 2 0 1
1 0 1 0 1 2 1 0 1 2 1 2 1 2 1 0 1
1 0 0 2 0 0 2 0 0 0 0 0 2 0 2 0 1
1 0 1 0 1 2 1 2 1 2 1 2 1 2 1 0 1
1 0 0 2 0 0 2 0 0 0 0 0 2 0 5 0 1
1 1 1 1 1 1 1 1 1 1 1 1 1 1 1 1 1